"a" = (/turf/space,/area)
"b" = (/turf/simulated/floor/plating,/area)
"c" = (/obj/machinery/power/smes/magical,/turf/simulated/floor/plating,/area)
"d" = (/obj/cable{icon_state = "1-2"; d1 = 1; d2 = 2},/turf/simulated/floor/plating,/area)

(1,1,1) = {"
aaaaaaaaaa
aaaaaaaaaa
aaaaaaaaaa
aaaaaaaaaa
aabbbaaaaa
aabcbaaaaa
aabdbaaaaa
aaaaaaaaaa
aaaaaaaaaa
aaaaaaaaaa
"}
